####################################
#..................................#
#..................................#
#..................................#
#.......#################..........#
#.......................#..........#
#.................X.....#..........#
#.......................#..........#
#.......................#..........#
#..............X........#..........#
#.......................#####......#
#.........#######..................#
#.........#.....#..................#
#.........#.....#..................#
#.........#.....####....####.......#
#.........#................#.......#
#......@..#................#.......#
#........####..............#.......#
#..........................#.......#
#................####..............#
#..................................#
#..................................#
#..................................#
####################################